acc -> case

acomp -> xcomp

acomp-lvc -> compound:lvc

compound:lvc -> compound:lvc

advcl -> advcl

advmod -> advmod

amod -> amod 

appos -> appos

aux -> aux 

auxpass -> auxpass

cc -> cc

ccomp -> ccomp

complm ->mark

conj -> conj

cop -> cop

#cpobj -> pobj(-ra)

#cprep -> prep(-ra)

dep -> dep 

dep-top -> dislocated

dep-voc -> vocative

det -> det 

dobj -> dobj

dobj-lvc -> compound:lvc

fw -> foreign

mark -> mark 

mwe -> mwe

neg -> neg 

#nn -> compound

nn -> name

npadvmod -> noun

nsubj -> nsubj 

nsubj-lvc -> compound:lvc 

nsubjpass -> nsubjpass

num -> num

number -> compound

parataxis -> parataxis

#pobj ------------------------------->  must be checked manually

pobj.NOUN -> nmod 

poss -> nmod:poss

preconj -> conj:preconj

predet -> det:predet

prep -> case 

prep-ra -> case

prep-lvc -> case

prep-lvc-ra -> case

prt -> compound:prt

punct -> punct

quantmod -> advmod

rcmod -> acl:relcl

rel -> mark

root -> root

tmod -> advmod

xcomp -> xcomp



